111111111111111111111111111
1111P00E1100000000000001111
1111100C0000000110000000C11
111111111111111111111111111