111111
1P00E1
1C0101
1000C1
111111