111111111111
11C010100001
100011100101
1E01110001C1
110001110001
11C1000P0111
111111111111