11111111111
100X00CX111
111E0X000X1
10011XXP001
11111111111